111111111111111111111111111111111111111111111111111111111111
100000000000000000000000000000000000000000000000000000111111
100000000000000000000000000000000000000000000000000000111111
100000000000000000000000000000000000000000000000000000111111
100000000000000000000000000000000000000000000000000000011111
100000000000000000000000000000000000000000000000000000011111
100000000000000000000000000000000000000000000000000000011111
100000000000000000000000000000000000000000000000000000011111
100000000000000000000000000000000000000000000000000000011111
100000000000000000000000000000000000000000000000000000011111
100000000000000000000000000000000000000000000000000000011111
100000000000000000000000000000000000000000000000000000011111
100000000000000000000000000000000000000000000000000000011111
100000000000000000000000000000000000000000000000000000011111
100000000000000000000000000000000000000000000000000000011111
10000000000000000000000000000M0000M0000M000M00M0M00000011111
100000000000000000000000000000000000000000000000000000011111
100000000000000000000000000000000000000000000000000000011111
100000000000000000000000000000000000000000000000000000011111
100000000000000000000000000000000000000000000000000000011111
100000000000000000000000000000000000000000000000000000011111
100000000000000000000000000000000000000000000000000000001111
100000000000000000000000000000000000000000000C00E000P0001111
100000000000000000000000000000000000000000000000000000000111
100000000000000000000000000000000000000000000000000000000111
100000000000000000000000000000000000000000000000000000000111
100000000000000000000000000000000000000000000000000000000111
100000000000000000000000000000000000000000000000000000000111
110000000000000000000000000000000000000000000000000000000011
100000000000000000000000000000000000000000000000000000000111
100000000000000000000000000000000000000000000000000000000111
111111111111111111111111111111111111111111111111111111111111
111111111111111111111111111111111111111111111111111111111111