111111111111111111111111111111111111111111111111111111111111
100000000000000000000000000000000000000000000000000000001111
100000000000000000000000000000000000000000000000000000001111
100000000000000000000000000000000000000000000000000000001111
100000000000000000000000000000000000000000000000000000001111
100000000000000000000000000000000000000000000000000000001111
100000000000000000000000000000000000000000000000000000001111
100000000000000000000000000000000000000000000000000000001111
100000000000000000000000000000000000000000000000000000001111
100000000000000000000000000000000000000000000000000000001111
100000000000000000000000000000000000000000000000000000001111
100000000000000000000000000000000000000000000000000000001111
100000000000000000000000000000000000000000000000000000001111
100000000000000000000000000000000000000000000000000000001111
100000000000000000000000000000000000000000000000000000001111
100000000000000000000000000000000000000000000000000000001111
100000000000000000000000000000000000000000000000000000001111
100000000000000000000000000000000000000000000000000000001111
100000000000000000000000000000000000000000000000000000001111
100000000000000000000000000000000000000000000000000000001111
100000000000000000000000000000000000000000000000000000001111
100000000000000000000000000000000000000000000000000000000111
1000000000000000000000000000000000000000000000C00E000P000111
100000000000000000000000000000000000000000000000000000000011
100000000000000000000000000000000000000000000000000000000011
100000000000000000000000000000000000000000000000000000000011
100000000000000000000000000000000000000000000000000000000011
100000000000000000000000000000000000000000000000000000000011
100000000000000000000000000000000000000000000000000000000011
100000000000000000000000000000000000000000000000000000000011
100000000000000000000000000000000000000000000000000000000011
100000000000000000000000000000000000000000000000000000000011
111111111111111111111111111111111111111111111111111111111111